I’m crazy for @	I am crazy for sports @ Я без ума от спорта
My favorite @	My favorite movie is Inception@Мой любимый фильм — «Начало»
I like	@ I like playing soccer with my brother@Мне нравится играть в футбол с моим братом
I love	@ 	I love doing yoga	@Я люблю заниматься йогой
I hate	@ 	I hate eating vegetables	@Я ненавижу есть овощи
I really hate	@ 	I really hate doing exercises at school	@Я действительно ненавижу делать упражнения в школе
I really adore	@ 	I really adore happy endings	@Я действительно обожаю счастливые концовки
I detest		@ I detest having to come here every summer	@Я ненавижу приезжать сюда каждое лето
[noun] is OK	@ 	A Pepsi is OK	@Pepsi норм
I really like	@ 	I really love going to the beach with my children	@Я очень люблю ходить на пляж с детьми
I really don’t like		@ I really don’t like going to the movies	@Мне очень не нравится ходить в кино
I don’t like	@ 	I don’t like heavy metal	@Я не люблю хэви-метал
I love	@ I love eating ice-cream	@ Я люблю есть мороженое
I adore 	@ I adore sun-bathing	@ Я обожаю загорать
She’s mad about	@ She’s mad about that new boy band	@Она без ума от этой новой бойз-бэнда
He’s crazy about 	@ He’s crazy about that girl	@Он без ума от этой девушки
She’s fond of 	@ She’s fond of chocolate	@Она любит шоколад
I like 	@ I like swimming very much	@ Я очень люблю плавать
He really likes	@ He really likes that new golf course (Remember to stress really in this sentence.)	@ Ему очень нравится это новое поле для гольфа (Не забудьте поставить ударение в этом предложении.)
He quite likes 	@ He quite likes going to the cinema	@Ему очень нравится ходить в кино
I like 	@ I like cooking	@Я люблю готовить
I don’t mind	@ I don’t mind doing the housework	@ Я не против делать работу по дому
I don’t really care 	@ I don’t really care either way	@ Мне все равно в любом случае
I don’t really care@ I don’t really care to me	@Мне на самом деле все равно
She doesn’t like 	@ She doesn’t like cooking very much	@Она не очень любит готовить
He’s not very fond of 	@ He’s not very fond of doing the gardening	@Он не очень любит заниматься садоводством
He’s not a great fan of 	@ He’s not a great fan of football	@Он не большой фанат футбола
isn’t really his thing	@ Horse-riding isn’t really his thing	@Верховая езда не совсем его конек
I dislike 	@ I dislike wasting time	@Я не люблю тратить время
I don’t like 	@ I don’t like sport at all	@Я вообще не люблю спорт
He can’t stand 	@ He can’t stand his boss	@Он терпеть не может своего босса
She can’t bear 	@ She can’t bear cooking in a dirty kitchen	@Она терпеть не может готовить на грязной кухне
I hate 	@ I hate crowded supermarkets	@ я ненавижу переполненные супермаркеты
He detests 	@ He detests being late	@Он ненавидит опаздывать
She loathes 	@ She loathes celery	@Она ненавидит сельдерей
